CloseHandle=FileSafeHandle
FreeLibrary=LibrarySafeHandle
DeleteTimerQueue=TimerQueueSafeHandle
CloseThreadpool=ThreadpoolSafeHandle
ClosePrivateNamespace=PrivateNamespaceSafeHandle
DeleteBoundaryDescriptor=BoundaryDescriptorSafeHandle
FindClose=FindSafeHandle
CloseEventLog=EventLogSafeHandle
FindVolumeClose=FindVolumeSafeHandle
FindVolumeMountPointClose=FindVolumeMountPointSafeHandle
SHChangeNotification_Unlock=SHChangeNotificationSafeHandle
LeaveCriticalPolicySection=CriticalPolicySectionSafeHandle
WTSVirtualChannelClose=WTSVirtualChannelSafeHandle
IcmpCloseHandle=IcmpHandleSafeHandle
DeleteDC=HDCSafeHandle
DeleteMetaFile=MetaFileSafeHandle
FindCloseChangeNotification=FindChangeNotificationSafeHandle
HeapDestroy=HeapSafeHandle
DeleteObject=GdiSafeHandle
DeleteColorSpace=ColorSpaceSafeHandle
CloseDesktop=DesktopSafeHandle
CloseWindowStation=WindowStationSafeHandle
CloseWindowStation=WindowStationSafeHandle
DestroyAcceleratorTable=AcceleratorTableSafeHandle
DestroyMenu=MenuSafeHandle
DestroyCursor=CursorSafeHandle
DestroyIcon=IconSafeHandle
DestroyPropertySheetPage=PropertySheetPageSafeHandle
RegCloseKey=RegKeySafeHandle
ImageList_Destroy=ImageListSafeHandle
WNetCloseEnum=WNetEnumSafeHandle
PerfStopProvider=PerfProviderSafeHandle
DnsReleaseContextHandle=DnsContextHandleSafeHandle
FilterClose=FilterSafeHandle
FilterVolumeFindClose=FilterVolumeFindSafeHandle
DsGetDcCloseW=DsGetDcSafeHandle
TdhCloseDecodingHandle=TdhDecodingSafeHandle
FilterVolumeInstanceFindClose=FilterVolumeInstanceFindSafeHandle
FilterInstanceClose=FilterInstanceSafeHandle
FilterFindClose=FilterFindSafeHandle
FilterInstanceFindClose=FilterInstanceFindSafeHandle
PerfCloseQueryHandle=PerfCloseQuerySafeHandle
LsaDeregisterLogonProcess=LsaLogonProcessSafeHandle
WSACloseEvent=WSAEventSafeHandle
CertFreeCertificateChainEngine=CertCertificateChainEngineSafeHandle
CryptCloseAsyncHandle=CryptCloseAsyncSafeHandle
DeleteEnhMetaFile=DeleteEnhMetaFileSafeHandle
DeregisterEventSource=EventSourceSafeHandle
